服务维度,正面评价,负面评价,中性评价,总评价数,正面率,负面率
前台服务,412,16,40,468,88.03,3.42
客房服务,636,23,64,723,87.97,3.18
餐饮服务,326,11,22,359,90.81,3.06
设施设备,417,17,31,465,89.68,3.66
位置交通,151,6,5,162,93.21,3.7
清洁卫生,242,8,13,263,92.02,3.04
价格性价比,109,11,11,131,83.21,8.4
SPA水疗,12,1,1,14,85.71,7.14
亲子活动,58,2,5,65,89.23,3.08
停车服务,40,2,2,44,90.91,4.55
